111111
1P0C01
111101
1C10E1
111111