1111111111
1P0000C001
1000000111
1C0000C1E1
1111111111