111111111
1E0010C01
1000P0001
1000C0011
111111111