1111111111111111111111111111111111
1EC000000000000C00000C000000000101
1C10010100100000101001000000010101
1010010010101010001001000000010101
100P00000C00C0000000000000000001C1
1111111111111111111111111111111111